0111110000
0000010100
0001010000
0101010110
0101010100
0111010101
0000000101
0001100100
1000000100
0000100100